111111
1CE111
1CP111
111111
111111