11111111111111111
1EE000C00000C0011
10100101001001011
10100110100100011
1P00000C00C000011
11111111111111111